xxxxxxxxxxxxxxxxxxxxxxxxxxxxxx
x1------------21------------2x
x|............||............|x
x|.1--2.1---2.||.1---2.1--2.|x
x|.|xx|.|xxx|.||.|xxx|.|xx|.|x
x|.4--3.4---3.43.4---3.4--3.|x
x|..........................|x
x|.1--2.12.1------2.12.1--2.|x
x|.4--3.||.4--21--3.||.4--3.|x
x|......43....||....43......|x
x4------------34------------3x
xxxxxxxxxxxxxxxxxxxxxxxxxxxxxx